NO ./texture/east-StoneUWD.xpm
EA ./texture/east-StoneUWD.xpm
WE ./texture/east-StoneUWD.xpm
SO ./texture/east-StoneUWD.xpm

F 112,80,47
C 35,53,88

111111111111111111111111111111111111
100000000000000000000000000000000001
101111111111111111111111111111111101
101000100000000000000000000001000101
101011111111111111111011111110110101
101011111111111000111010000000100101
101011111111111010111010111110110101
101011111110000010000000111110110101
101011111110111110111110111110110101
101011111110110000001110111110110101
101000000000111111100000111110110101
101011111111111111101111111110110101
101010000001100000001111111110110101
101011111111101111111111111110110101
101010000011101111111111100000000101
101011111111101111111111101111100101
101011111111101111111111101111110101
101011111111100000011111101111110101
101011111111100000000000000111110101
101011111111100000011111000011110101
101011111111100000011111111011110101
101011111111111111111111111011110101
101011111111111000001111111011110101
101011111111111011101111111011100101
101011111111111011101011111011110101
101011110000001011101011111011110101
101011110110101010111011111011100101
101011110000101010111011111000000101
101011111111101010000011111111110101
101011100001110000001011111111110101
101010111110111110111011111111110101
101010000000101000100000111111110101
101011111111101111100000111111110101
101000000000000000000000000000000101
10111111111111111100N001111111111101
100000000000000000000000000000000001
111111111111111111111111111111111111
